####################
#.....###..###.....#
#...##........##...#
#..#............#..#
#.#..............#.#
#.#..............#.#
##................##
##................##
##........S.......##
#..................#
#..................#
##................##
##........S.......##
##................##
#.#..............#.#
#.#..............#.#
#..#............#..#
#...##........##...#
#.....###..###.....#
####################