####################
#..................#
#..................#
#.............#....#
#.....##########...#
#........#.....#...#
####...........#...#
#...#...##...###...#
#.S..#.......#..S..#
#....#..#....#.....#
#....#..#....#.#...#
#.......#..#..###..#
####...........#...#
#......#....#......#
#.........#........#
#.....########.....#
#..................#
#..................#
#..................#
####################