####################
######........######
######..#..S.#######
#######.......######
######..#..#..######
######........######
######..#...#.######
#######...#...######
######..#....#######
######.....#..######
######...#....######
######..#..#..######
#######.....#.######
######........######
######.#..#..#######
######.....#..######
######..#.....######
######....S.#.######
######.#......######
####################