####################
#..............E...#
#..................#
#.............#....#
#.....#########....#
#..................#
#..............#...#
####...###...###...#
#......#...........#
#......#...........#
#......#...####....#
#.............###..#
#####.........#....#
#..................#
#.........#........#
#.....########.....#
#..................#
#..S...............#
#..................#
####################
